090201000
004008070
070069008
140005800
060000020
008600047
200340060
030100700
000802010