008632400
040000010
500904006
800000005
600000004
107000902
400751003
060000020
005826700

From: https://blog.eduprintable.com/