005000100
070501320
060000700
000943000
800200009
924070010
000004005
540109000
006002041